0 0 0 0 0 0 0 13 13 11 0 0 0 10 0 0 0 0 0 0
11 0 10 0 0 0 11 12 12 0 0 0 0 0 0 0 0 10 0 0
13 13 0 0 0 0 0 0 0 0 0 0 0 0 0 0 0 0 0 0
0 0 0 1 1 1 1 1 1 2 0 0 1 1 1 1 1 1 1 5
0 0 0 3 0 0 0 0 0 2 0 0 3 0 0 0 0 0 0 0
0 0 0 3 0 0 2 4 4 4 0 0 3 0 0 0 0 13 13 0
0 0 0 3 0 0 2 0 0 0 0 0 3 0 0 11 0 13 10 0
0 0 0 3 0 0 2 0 0 0 0 0 3 0 0 12 12 0 0 0
0 0 0 3 0 0 2 0 0 0 0 0 3 0 0 10 0 11 0 0
1 1 1 3 0 0 1 1 1 1 1 1 3 0 0 13 11 0 0 0
0 0 11 0 0 0 0 12 0 0 0 0 0 0 0 11 0 0 0 0
11 0 0 0 0 10 10 0 0 13 0 0 0 0 0 0 0 0 0 0
0 0 0 0 0 0 0 0 0 0 0 0 0 0 0 0 0 0 0 0